111111111111111111111111
100000010000000000000001
100000010000100000000001
100010010000111111100111
100111111111110000000101
100001000000000001111101
100001000001110000000001
100000000000010000000001
111111111111111111111111